26
16
1

47 141 168 168 168 143 47 26 47 26 47 26 47 47 47 47 47 26 47 26 47 26 47 47 47 47 
47 141 168 168 168 143 47 26 47 26 47 26 47 47 47 47 47 74 47 26 47 26 47 47 47 47 
47 141 168 168 168 143 47 72 73 73 73 73 47 47 47 47 47 73 73 73 73 74 47 47 47 47 
47 164 165 165 165 166 47 95 73 73 73 73 73 73 73 73 73 73 73 73 73 97 47 47 47 47 
47 47 47 47 47 47 47 47 95 73 73 73 73 73 73 73 73 73 73 73 97 47 47 47 47 47 
47 47 47 47 47 47 47 47 47 72 73 27 73 73 73 73 73 73 27 74 47 47 47 47 47 47 
79 79 79 79 79 79 79 79 79 72 73 73 73 73 73 73 73 73 73 74 79 79 79 79 79 79 
47 47 47 47 47 47 47 47 47 95 96 96 96 98 98 98 96 96 96 97 47 47 47 47 47 47 
47 47 47 47 47 47 47 47 47 47 47 47 47 47 47 47 47 47 47 47 47 47 47 47 47 47 
73 73 73 73 73 73 73 73 73 73 73 73 73 149 150 73 73 73 73 73 73 73 73 73 73 73 
438 438 438 438 438 392 392 392 392 392 392 392 72 172 173 74 392 392 392 392 392 392 392 392 392 392 
385 385 385 385 385 385 385 375 385 385 385 385 72 172 173 74 385 385 385 385 443 556 556 556 556 556 
24 24 24 24 24 24 24 24 24 24 24 25 72 172 173 74 23 24 24 24 141 168 191 191 191 191 
47 47 47 47 47 47 47 47 47 47 47 47 95 172 173 97 47 47 47 47 141 143 47 47 47 47 
47 47 47 47 47 47 47 47 47 47 47 47 47 141 263 119 119 119 119 119 309 143 47 47 47 47 
47 47 47 47 47 47 47 47 47 47 47 47 47 164 165 165 165 165 165 165 165 166 47 47 47 47 