20
15
1

47 47 47 47 47 47 47 47 47 47 47 47 47 47 47 47 47 47 47 47 
47 47 47 47 47 47 47 47 47 47 47 47 47 47 47 47 47 47 47 47 
47 47 47 47 47 47 47 47 47 47 47 47 47 47 47 47 47 47 47 47 
47 47 47 54 54 54 54 54 54 54 54 54 54 47 47 47 47 47 47 47 
47 47 47 54 73 73 73 73 73 73 73 73 54 47 47 47 47 47 47 47 
47 47 47 54 73 73 47 47 47 47 47 73 54 47 47 47 47 47 47 47 
47 47 47 54 54 73 47 47 47 47 47 73 54 47 47 47 47 47 47 47 
47 47 47 47 54 73 47 47 47 47 47 73 54 47 47 47 47 47 47 47 
47 47 47 47 54 73 73 73 73 73 73 73 54 47 47 47 47 47 47 47 
47 47 47 47 54 54 54 54 54 54 54 54 54 47 47 47 47 47 47 47 
47 47 47 47 47 54 54 54 54 47 47 47 47 47 47 47 47 47 47 47 
47 47 47 47 47 47 47 47 47 47 47 47 47 47 47 47 47 47 47 47 
47 47 47 47 47 47 47 47 47 47 47 47 47 47 47 47 47 47 47 47 
47 47 47 47 47 47 47 47 47 47 47 47 47 47 47 47 47 47 47 47 
47 47 47 47 47 47 47 47 47 47 47 47 47 47 47 47 47 47 47 47 